7 7 7 7 7 7 7 7 7 7 7 7 7 7 7 7 7 7 7 7 7 7 7 7 7 7 7 7 7 7 7 7 7 7 7 7 7 7 7 7 7 7 7 7 7 7 7 7 7 7 7 7 7 7 7 7 7 7 7 7 7 7 7 7 7 7 7 7 7 7 
7 6 4 3 3 3 4 0 0 0 0 0 0 0 0 0 0 0 0 0 0 0 0 0 0 0 0 0 0 0 0 0 0 0 0 0 6 6 6 6 6 6 6 6 6 6 6 6 6 6 6 6 6 6 6 6 6 6 6 6 6 6 6 6 6 6 6 6 6 7
7 0 4 3 3 3 4 0 0 0 0 0 0 0 0 0 0 0 0 0 0 0 0 0 0 0 0 0 0 0 0 0 0 0 0 0 6 6 6 0 0 0 0 0 0 0 0 0 0 0 0 0 0 0 0 0 0 0 0 0 0 0 0 0 0 0 0 0 6 7
7 0 4 3 3 3 4 0 0 0 0 0 0 0 0 0 0 0 0 0 0 0 0 0 0 0 0 0 0 0 0 0 0 0 0 0 6 6 0 0 0 0 2 2 0 0 2 2 0 6 0 0 0 0 0 0 0 0 6 0 2 2 0 0 2 2 0 0 6 7
7 6 4 3 3 3 4 0 0 0 0 0 0 0 0 0 0 0 0 0 0 0 0 0 0 0 0 0 0 0 0 0 0 0 0 0 6 6 0 0 5 0 2 2 0 0 2 2 0 0 0 5 0 5 0 5 0 0 0 0 2 2 0 0 5 0 0 0 6 7
7 0 4 3 3 3 4 0 0 0 9 0 0 0 9 0 0 0 9 0 0 0 9 0 0 0 9 0 0 0 9 0 0 0 0 0 6 6 6 0 0 0 0 0 0 6 0 0 0 0 0 0 0 0 0 0 0 0 0 0 0 0 6 0 0 0 0 0 6 7
7 0 4 3 3 3 4 0 0 0 8 0 0 0 8 0 0 0 8 0 0 0 8 0 0 0 8 0 0 0 8 0 0 0 0 0 6 6 0 2 2 0 5 0 0 0 0 5 0 2 2 0 0 6 0 0 2 2 0 5 0 0 0 0 2 2 2 0 6 7
7 0 4 3 3 3 4 0 0 0 3 0 0 0 3 0 0 0 3 0 0 0 3 0 0 0 3 0 0 0 3 0 0 0 0 0 6 6 6 0 0 0 0 0 5 0 0 0 0 0 0 0 5 0 5 0 0 0 0 0 0 5 0 0 0 0 0 0 6 7
7 6 4 3 3 3 3 3 3 3 3 3 3 3 3 3 3 3 3 3 3 3 3 3 3 3 3 3 3 3 3 3 3 3 3 3 6 6 6 2 2 0 5 0 0 0 0 5 0 2 2 0 0 6 0 0 2 2 0 5 0 0 0 0 2 2 2 0 6 7
7 0 4 3 3 3 4 0 0 0 3 0 0 0 3 0 0 0 3 0 0 0 3 0 0 0 3 0 0 0 3 0 0 0 0 3 6 6 6 0 0 0 0 0 0 6 0 0 0 0 0 0 0 0 0 0 0 0 0 0 0 0 6 0 0 0 0 0 6 7
7 0 4 3 3 3 4 0 9 0 3 0 9 0 3 0 9 0 3 0 9 0 3 0 9 0 3 0 9 0 3 0 9 0 0 3 6 6 0 0 5 0 2 2 0 0 2 2 0 0 0 5 0 5 0 5 0 0 0 0 2 2 0 0 5 0 0 0 6 7
7 0 4 3 3 3 4 0 8 0 3 0 8 0 3 0 8 0 3 0 8 0 3 0 8 0 3 0 8 0 3 0 8 0 0 3 6 6 6 0 0 0 2 2 0 0 2 2 0 6 0 0 0 0 0 0 0 0 6 0 2 2 0 0 2 2 0 0 6 7
7 6 4 3 3 3 4 6 3 6 3 6 3 6 3 6 3 6 3 6 3 6 3 6 3 6 3 6 3 6 3 6 3 6 0 3 6 6 0 0 0 0 0 0 0 0 0 0 0 0 0 5 0 5 0 5 0 0 0 0 0 0 0 0 0 0 0 0 6 7
7 0 4 3 3 3 4 4 3 4 3 4 3 4 3 4 3 4 3 4 3 4 3 4 3 4 3 4 3 4 4 4 3 4 4 3 6 6 6 0 0 6 6 0 0 6 0 6 0 6 0 6 0 6 0 6 0 6 0 6 0 6 6 6 0 6 6 0 6 7
7 0 4 3 3 3 3 3 3 3 3 3 3 3 3 3 3 3 3 3 3 3 3 3 3 3 3 3 3 3 3 3 3 3 3 3 2 2 2 0 0 2 0 0 0 2 0 0 0 0 2 0 2 0 0 0 0 0 0 2 0 0 0 0 0 2 0 2 6 7
7 0 4 3 3 3 3 3 3 3 3 3 3 3 3 3 3 3 3 3 3 3 3 3 3 3 3 3 3 3 3 3 3 3 3 3 2 2 2 0 0 0 2 0 2 0 0 0 2 0 0 0 0 0 2 0 0 0 0 2 0 2 0 0 2 2 0 2 6 7 
7 6 4 3 3 3 3 3 3 3 3 3 3 3 3 3 3 3 3 3 3 3 3 3 3 3 3 3 3 3 3 3 3 3 3 3 2 2 2 0 0 0 0 0 0 0 0 0 0 0 2 0 0 0 0 0 0 2 0 2 0 0 0 2 0 2 2 0 6 7
7 0 4 3 3 3 4 4 3 4 3 4 3 4 3 4 3 4 3 4 3 4 3 4 3 4 3 4 3 4 3 4 3 4 4 3 6 6 0 6 6 0 6 0 0 0 6 0 0 6 0 6 6 0 6 6 0 6 0 0 0 6 0 0 6 0 6 0 6 7
7 0 4 3 3 3 4 6 3 6 3 6 3 6 3 6 3 6 3 6 3 6 3 6 3 6 3 6 3 6 3 6 3 6 0 3 6 6 6 0 0 6 0 0 5 0 0 5 0 0 5 0 0 6 0 0 5 0 0 5 0 0 5 0 0 6 0 0 6 7
7 0 4 3 3 3 4 0 8 0 3 0 8 0 3 0 8 0 3 0 8 0 3 0 8 0 3 0 8 0 3 0 8 0 0 3 6 6 0 0 5 0 0 6 0 0 5 0 0 6 0 0 5 0 0 6 0 0 5 0 0 6 0 0 5 0 0 0 6 7
7 6 4 3 3 3 4 0 9 0 3 0 9 0 3 0 9 0 3 0 9 0 3 0 9 0 3 0 9 0 3 0 9 0 0 3 6 6 6 0 0 0 5 0 0 2 2 0 0 5 0 6 0 0 6 0 5 0 0 2 2 0 0 5 0 0 0 0 6 7
7 0 4 3 3 3 4 0 0 0 3 0 0 0 3 0 0 0 3 0 0 0 3 0 0 0 3 0 0 0 3 0 0 0 0 3 6 6 0 2 2 0 0 5 0 0 6 0 0 5 0 0 2 2 0 0 5 0 0 6 0 0 5 0 2 2 0 6 6 7
7 0 4 3 3 3 4 3 3 3 3 3 3 3 3 3 3 3 3 3 3 3 3 3 3 3 3 3 3 3 3 3 3 3 3 3 6 6 0 0 0 5 0 0 6 0 0 5 0 0 5 0 0 6 0 0 5 0 0 5 0 0 6 0 0 5 0 0 6 7
7 0 4 3 3 3 4 0 0 0 3 0 0 0 3 0 0 0 3 0 0 0 3 0 0 0 3 0 0 0 3 0 0 0 0 0 6 6 6 2 2 0 0 5 0 0 6 0 0 5 0 0 2 2 0 0 5 0 0 6 0 0 5 0 2 2 0 0 6 7
7 6 4 3 3 3 4 0 0 0 8 0 0 0 8 0 0 0 8 0 0 0 8 0 0 0 8 0 0 0 8 0 0 0 0 0 6 6 0 0 0 0 5 0 0 2 2 0 0 5 0 6 0 0 6 0 5 0 0 2 2 0 0 5 0 0 0 0 6 7
7 0 4 3 3 3 4 0 0 0 9 0 0 0 9 0 0 0 9 0 0 0 9 0 0 0 9 0 0 0 9 0 0 0 0 0 6 6 6 0 5 0 0 6 0 0 5 0 0 6 0 0 5 0 0 6 0 0 5 0 0 6 0 0 5 0 0 0 6 7
7 0 4 3 3 3 4 0 0 0 0 0 0 0 0 0 0 0 0 0 0 0 0 0 0 0 0 0 0 0 0 0 0 0 0 0 6 6 0 0 0 6 0 0 5 0 0 5 0 0 5 0 0 6 0 0 5 0 0 5 0 0 5 0 0 6 0 0 6 7
7 0 4 3 3 3 4 0 0 0 0 0 0 0 0 0 0 0 0 0 0 0 0 0 0 0 0 0 0 0 0 0 0 0 0 0 6 6 6 0 0 0 0 0 0 0 0 0 0 0 0 0 0 0 0 0 0 0 0 0 0 0 0 0 0 0 0 0 6 7
7 6 4 3 3 3 4 0 0 0 0 0 0 0 0 0 0 0 0 0 0 0 0 0 0 0 0 0 0 0 0 0 0 0 0 0 6 6 6 6 6 6 6 6 6 6 6 6 6 6 6 6 6 6 6 6 6 6 6 6 6 6 6 6 6 6 6 6 6 7
7 7 7 7 7 7 7 7 7 7 7 7 7 7 7 7 7 7 7 7 7 7 7 7 7 7 7 7 7 7 7 7 7 7 7 7 7 7 7 7 7 7 7 7 7 7 7 7 7 7 7 7 7 7 7 7 7 7 7 7 7 7 7 7 7 7 7 7 7 7